OOOOOOOOOOOOOOOOOOOOOOOOOOOOOOOOOOOOOOOOOG
OGGGOOOOOOOOOOOOOOOOOOOOOOOOOOOOOOOOOOOOOG
JOROOOOOOSSGOROOOOOOOOOOOOOOOOOOOOOOOOOOOG
GGGGOOGGGGGGGGGGGGGGGGGGGGGGGGGGGGGOOGGGOG
GOOOOOOOOOOOOOOOORGOOOOOOOOOOOOOOOOOOOOGOG
GOOOGOOOOOCCCCOOOOCOOOOOOOOOOOOOOOOOOOOGOG
GOOOOOOOOOGGGGOOOOGOOOOOOOOOOOOOOOGOOOOGOG
GOOOOOOGPOOMOOOOOOCOOOOOOOOOOOOOOOOOOOOGOG
OWOOROGGGGGGOOOOOOGOOOOOOKOWOOCCCOOOOSSGOG
GGGGGGGGGGGGGGGGGGGGGGGGGGGGGGGGGGGGGGGGOG
GGGGGGGGGGGGGGGGGGGGGGGGGGGGGGGGGGGGGGGGOG
GGGGGGGGGGGGGGGGGGGGGGGGGGGGGGGGGGGGGGGGOG
GGGGGGGGGGGFOOOOOOOOOOOOOOOOOOOOOOOOOOOOOG
GGGGGGGGGGGGGGGGGGGGGGGGGGGGGGGGGGGGGGGOOG
GGGGGGGGGGGGGGGGMOOOGGGGGGGGGGGGGGGGGGGGOG
GGGGGGGGGGGGGGGGGGGOOGGGGGGGGGOOOOOOOOOOOG
GCCOOOOOOOOOOOOOOOOOOOOOOOOOOOOOOKOOOOOOOG
GGGGGGGGGGGGGGGGGGGGGGGGGGGGGGGGGGGGOOOOGG
GGGGGGGGGGGGOOROOGGGGGGGGGGGGGGGGGGGGGOOGG
GGGGGGGGGGGGGGGGGGGGGGGGGGGGGGGGGGGGGOOOGG