GGGGGGGGGGGGGGGGGGGGGGGGGGGGGGGGGGGGG
GOOOOPGOOOOOOOOOOOOOOOOOOOOOOOOOOOOJG
GOOOGGGOOOOOOGGGGGGGGGGOOOOOOOOOGGGGG
GOOOOKOOOOOOOOOOOCCOOOOKOOOGOOOOOOOOG
GGGGGGGGGGGGGGGGGGGGGGGGGGGGGGGGGGOOG
FOOOOOOOOOOOOOOOOCCOOOOOOOOOOOOOOOOOG
GOOOOOOOOOOOOOOOOOOOOOOROOOOOOOOOOOOG
GGGOOGOOGOKOOOOOOOGOOOGOOOOOOOOOOOOGG
GGGSSSSSGGGGGGGGGGGOOGGGGGGGGGGGGGGGG
GGGGGGGGGGGGGGGGGGGOOGGGGGGGGGGGGGGGG