JOOOOOOOOOOOOOOOOOOOOOOOOOOOOOOOOOOOOOOOOOOOOOOOOOOOOOOOOOOOOOOOOOOOOOOOOOOOOOOOOOOOOOOOOOOOOOOOOOOOOOOOOOOOOOO
GOOOCCCOOOOOOOOOOCOOOOOOOOOOOOOOOOOOOOOOOOOOOOOOOOOOOOOOOGGGROOOOOOOOOOOOOOOKGGOOOOOOOOOOOOOOOOOOOOOOOOOOOOOOOO
GOOGGGGGOOOOOGGGOOOGGGOOOOOOOOOOOOOOOOOOOOOOOOOOOOOOOOGOOOOGOOOOOOOOOOOOOOOOGGOOOOOOOSGSOOSGSOOOOOOOOOOOOOOOOOO
GPOOOOOOOOGSROOCCGMROKOSGOOOGGOOOGGGOOOGGOOOOOGOROOOOOOROGOOGGGGGGGGGGGGGGGGGOOOOOOOGGGGGGGGGGGGOOOOOOOOOOOOOOO
GGGGOOOOOOGGGGGGGGGGGGGGGOOOOOOOOOOOOOOOOOOGOOGGGGGGGGGGGGOOOOOOOOOOOOCCCCOOOOOOOGOOOOOOOOOOOOOOOOOOOOOGGOOOOOO
OOOOOOOOOOOOOOOOOOOOOOOOOOOOOOOOOOOOOOOOOOOOOOOOOOOOOOOOOOOGOOOOOOOGGOOROOJOOOOOOOOOOOOOOOOOOOOOOOOGGOOOOOOOOOF
OOOOOOOOOOOOOOOOOOOOOOOOOOOOOOOOOOOOOOOOOOOOOOOOOOOOOOOOOOOOGOOGGGOOOOGGGGGOOOOOOOOOOOOOOOOOOOOOOOOOOOOOOOOOGGG
SSSSSSSSSSSSSSSSSSSSSSSSSSSSSSSSSSSSSSSSSSSSSSSSSSSSSSSSSSSSSSSSSSSSSSSSSSSSSSSSSSSSSSSSSSSSSSSSSSSSSSSSSSSSSSS
GGGGGGGGGGGGGGGGGGGGGGGGGGGGGGGGGGGGGGGGGGGGGGGGGGGGGGGGGGGGGGGGGGGGGGGGGGGGGGGGGGGGGGGGGGGGGGGGGGGGGGGGGGGGGGG