GGGGGGGGGGGGGGGGGGGGGGGGGGGGGGGGGGGGGGGGGGGGGGGGGGGGGGGGG
OOOOOOOOOOMOOOOOOOGOOOOOOOOOOOOOOOOOOOOOOOOOOOOOOOMMMMMMG
OOOOOOOOOOGOOOOOOOGOOOOOOOOOOOOOOOOOOOOOOOOOOOOOOOGGGGGGG
OOOOWOOOOOOOOOOOOOGOOOOGGOOOOOOGGOOGOOOOKOOOOOOKOGOOOOOOG
OOOOGOOOOOOGOOOOOOOOOOOOOOOGGOOOOOOOGGGGGGGGGGGGGOOOOCCCG
OOOOOOOOOOOOOOOOGGGGOOOOOOOOOOOOOOOOOOOOOOOOOOOOOOOOOGGGG
OOOOOOOOOGOOOOOOOOGOOOOOOOOOOOGOOOOOOOOOOOOOOGOOOOOOOOOPG
FOWOOOOOOOOOOGOOOOGJROOWOOOOOROOOOOOOOOOOROOOGOOOOROOOGGG
GGGGGGGGGGGGGGGGGGGGGGGGGGGGGGGGGGGGGGGGGGGGGGGGGGGGGGGGG